000010000000000000!
000011100000000000!
000000100000111111!
000000100000100000!
000000100011100000!
000000100010000000!
000111100011100000!
000100000000100000!
000111111111100000!
000000000000000000!